0000000###0000000
0000000###0000000
#000000000000000#
#000000000000000#
#000000000000000#
#000000000000000#
#000000000000000#
#000000###000000#
#000000###000000#
###0000###0000###
0000000###0000000
###0000###0000###
#000000###000000#
#000000###000000#
#000000000000000#
#000000000000000#
#000000000000000#
#000000000000000#
#000000000000000#
0000000###0000000
0000000###0000000

