20000000000000000
20000000000000000
20000000000000000
20000000000000000
20000000000000000
20000000000000000
24440000000000000
50060000000000000
33330000000000000
33335000000000000
03330000000000000
00000000000000000
00000000000000000
00000000000000000
00000000000000000
00000000000000000
00000000000000000
00000000000000000
00000000000000000
00000000000000000
00000000000000000
00000000000000000
00000000000000000
